M000000000000000000000000000000000
0000000000000000000000000000000000
0000000000000000000000000000000000
0000000000000000000000000000000000
0000000000000000000000000000000000
0000000000000000000000000000000000
0000000000000000000000000000000000
0000000000000000000000000000000000
0000000000000000000000000000000000
0000000000000000000000000000000000
0000000000000000000000000000000000
0000000000000000000000000000000000
0000000000000011111000000000000000
0000000000011111111111100000000000
1111111111111111111111111111111111
//////////////////////
M000000000000000000000000000000000
0000000000000000000000000000000000
0000000000000000000000000000111111
0000000000000000000000000000000000
0000000000000000000000000000000000
0000000000000000000000000000000000
0000000000000000000000000000000000
0000000000000000111111000000000000
0000000000000000000000000000000000
0000000000000000000000000000000000
0000001111100000000000000000000000
0000000000000000000000000000000000
0000000000000000000000000000000000
111111111111111111111111111_______
111111111111111111111111111_______
/////////////////////
M000000000000000000000000000000000
0000000000000000000000000000000000
0001111111000000000000000000000000
0000000000000000000000111111111111
0000000000000000000000000000000000
0000000000000000010000000000000000
0000000000000000010000000000000000
0000000000000000010000000000000000
0000000000000000010000000000000000
0000000000000000010000000000000000
000000000011111111_____00000000000
0000000000000000000000000000000000
0000000000000000000000000000000000
0000000000000000000000000000000000
1111111111100000000000000000000000
//////////////////////
M000000000000000000000000000000000
1111000000000000000000011111111111
0000000000000000000000000000000000
0000000000000000000000000000000000
0000000011111110000000000000000000
0000000000000000000000000000000000
0000000000000000000000000000000000
0000000000000000000000000000000000
0000000000000000000000000000000000
0000000000000000000000000000000000
0000000000000000000000000000000000
0000000011111110000000000000000000
0000000000000000000000000000000001
0000000000000000000000000000000001
1111000000000000000000000000001111
//////////////////////
M000000000000000000000000000000000
0000000000000000000000000000000000
0000000000000000000000000000001111
1111000000000000000000000000000000
0000000000000000000000000000000000
0000000000000000000000000000000000
0000000111111000000000000000000000
0000000000000000000000000000000000
0000000000000000011111000000000000
0000000000000000000000000000000000
0000000000000000000000000000000000
0000000000000000000000000000000000
0000000000000000000000000000000000
000000111110000___________00000111
0000000000000000000000000000000111
//////////////////////
